000000000000000000000000000000000000000000000000000000000000000000000000000000000000000000000000000000000000000000000000000000000000000000000000000000000000000000000000000000000000
111111111111111111111000000000000000000110000000000000000001100000000000000000011000000000000000000110000000000000000001100000000000000000011000000000000000000111111111111111111111
110000000000000000111000000000000000000100000000000000000000000000001111100000000000000000000000000000000000111110000000000000000000000000001000000000000000000111000000000000000011
000000001000000000000000000010000000000000000000100111111111000000001000000000000000000010001000000000000000000010000000111111111100100000000000000000001000000000000000000010000000
111111111111111111111000000000000000000110000001000001000001100000010000010000010000000100000100000010000001000001000001100000010000010000011000000000000000000111111111111111111111
111001111111111111101000000010000000000000000000100000000000111111111001111111110000000000000000000000000000000000000000111111111111111111110000000000010000000000000000000100000000
000000000010000000000000000000100000000000000000001000000000000000000010000000001111111111111111111100000000001000000000000000000010000000000000000000100000000000000000001000000000
000000000000000000000000000000000000000000000000000000000000000000000000000000001111111111111111111100000100000000100000000001000000001000000000010000000010000000000100000000100000
